5 10
|--------|
|...|....|
|...|.@..|
|........|
|--------|
