5 10
|--------|
|...|..-.|
|...|.@..|
|........|
|--------|
